12 20
-1---------------22\
/6------------7--\-|
|----/-9--------8/-3
|----|-------------|
\-5--|------------4/
/--32/--------------
4-------------------
|-------------------
\6-\----------------
---|--/-\-/-\-------
---|--|-|-|-|-------
---\--/-\-/-\---89-#